1111111111
1       11
11111   11
1      111
1 111  111
111    111
1    11111
111     11
1        1
1111111111